NO ./res/bricks.png
SO ./res/bricks.png
WE ./res/dark-bricks.png
EA ./res/dark-bricks.png
C ./res/planks.png
F ./res/earth.png

 1111111
110000011
100101001
101000101
100000001
101000101
100101001
110000011
 1001001
 1001001
1100E0011
100111001
1001 1001
100111001
100000001
110000011
 1100011
  11111
